┌───────┐┌────────────────┐┌────┐┌───────────────────┐┌───────────────────┐┌─────────────┐
└─────┐ ││ ┌───┐ ┌──────┐ │└──┐ ││ ┌─────────┐ ┌───┐ │└──┐ ┌───┐ ┌──────┐ ││ ┌──────┐ ┌┐ │
┌────┐│ ││ │┌──┘ │┌────┐│ └──┐│ └┘ │┌───────┐│ │┌─┐│ └──┐│ │┌─┐│ │┌─┐┌──┘ ││ │┌─────┘ ││ │
│ ┌┐ ││ │└─┘│ ┌──┘│ ┌──┘└──┐ │└────┘│ ┌───┐ ││ ││ │└──┐ ││ ││ ││ ││ ││ ┌──┘└─┘│ ┌─────┘│ │
│ ││ ││ │┌──┘ │┌──┘ └─────┐│ └─────┐│ └──┐│ └┘ ││ │┌──┘ ││ └┘ ││ ││ └┘ └─────┐│ └──┐┌──┘ │
│ │└─┘│ ││ ┌──┘│ ┌───┐ ┌┐ │└─────┐ │└──┐ │└────┘│ ││ ┌──┘└────┘│ │└────────┐ │└──┐ │└──┐ │
│ │┌──┘ ││ │┌──┘ │┌─┐│ ││ └─────┐│ └──┐│ └──┐┌──┘ ││ └────────┐│ │┌────┐┌──┘ └──┐│ └──┐│ │
│ ││ ┌──┘│ ││ ┌──┘│ ││ │└───────┘└──┐ │└──┐ │└──┐ │└────────┐ ││ ││ ┌┐ │└─────┐ │└──┐ ││ │
│ ││ └───┘ ││ │┌──┘ ││ └───────────┐│ └──┐│ └──┐│ │┌───────┐│ ││ └┘ ││ └──┐┌──┘ └───┘ ││ │
│ │└───────┘│ │└──┐ │└───────────┐ │└──┐ │└──┐ ││ ││ ┌┐ ┌┐ ││ ││ ┌──┘└──┐ │└──────────┘│ │
│ └────────┐│ │┌──┘ └──┐┌────────┘ └──┐│ └───┘ ││ ││ ││ ││ ││ ││ └──┐┌──┘ │┌────┐┌─────┘ │
│ ┌──────┐ ││ ││ ┌─────┘│ ┌───┐ ┌─────┘└───────┘│ ││ ││ │└─┘│ │└──┐ ││ ┌──┘│ ┌┐ │└──┐ ┌──┘
│ │┌─────┘ ││ └┘ │┌─────┘ │┌──┘ │┌───────┐┌─────┘ ││ ││ └───┘ │┌──┘ ││ └───┘ ││ └──┐│ └──┐
│ │└──┐ ┌──┘│ ┌──┘│ ┌───┐ │└────┘│ ┌┐ ┌──┘│ ┌───┐ ││ │└───────┘└────┘└──┐ ┌──┘└──┐ │└────┘
│ └──┐│ └──┐│ │┌──┘ │┌──┘ │┌─────┘ ││ └───┘ └──┐│ ││ └──┐┌─────────────┐│ └─────┐│ └─────┐
│ ┌┐ │└────┘│ ││ ┌──┘│ ┌──┘│ ┌─────┘└──────────┘│ │└──┐ ││ ┌─────────┐ │└─────┐ │└─────┐ │
│ ││ └──┐┌──┘ ││ │┌─┐│ └──┐│ └──┐┌─┐┌───────────┘ └──┐│ └┘ │┌───────┐│ └──┐┌─┐│ │┌─┐┌──┘ │
│ │└──┐ ││ ┌──┘│ ││ │└──┐ │└──┐ ││ ││ ┌────────────┐ │└────┘│ ┌┐ ┌┐ │└──┐ ││ ││ ││ ││ ┌──┘
│ │┌─┐│ └┘ └──┐│ ││ └───┘ └──┐│ ││ ││ │┌────┐┌─────┘ │┌─┐┌──┘ ││ ││ │┌─┐│ ││ └┘ ││ ││ └──┐
│ ││ │└───────┘│ │└────────┐ ││ ││ ││ ││ ┌──┘│ ┌─────┘│ ││ ┌──┘│ ││ ││ ││ ││ ┌──┘│ │└──┐ │
│ └┘ └──┐┌────┐│ └────────┐│ ││ └┘ ││ ││ └──┐│ └─────┐│ └┘ │┌──┘ ││ └┘ ││ ││ │┌──┘ └──┐│ │
└──┐ ┌──┘│ ┌┐ │└────────┐ │└─┘│ ┌──┘│ │└──┐ │└─────┐ │└────┘│ ┌──┘└──┐ ││ ││ │└─────┐ ││ │
┌──┘ │┌──┘ ││ └────────┐│ │┌──┘ │┌──┘ │┌──┘ │┌────┐│ └─────┐│ └──┐┌─┐│ ││ ││ └──────┘ ││ │
└────┘│ ┌──┘└────────┐ ││ ││ ┌──┘│ ┌──┘│ ┌──┘│ ┌┐ │└─────┐ │└──┐ ││ ││ ││ │└────────┐ ││ │
┌────┐│ │┌────┐┌─────┘ ││ └┘ │┌──┘ │┌──┘ │┌──┘ ││ └─────┐│ └──┐│ ││ ││ ││ │┌─┐┌─────┘ ││ │
│ ┌┐ ││ ││ ┌┐ │└──┐ ┌──┘└────┘│ ┌──┘└──┐ ││ ┌──┘└──┐ ┌──┘└──┐ ││ ││ ││ ││ ││ ││ ┌─────┘│ │
│ ││ ││ └┘ ││ └──┐│ └─────┐┌──┘ │┌─────┘ ││ │┌────┐│ │┌────┐│ ││ ││ └┘ ││ ││ └┘ │┌────┐│ │
│ ││ │└──┐ │└──┐ │└─────┐ ││ ┌──┘└──┐ ┌──┘│ ││ ┌┐ ││ ││ ┌┐ ││ ││ │└──┐ ││ │└────┘│ ┌┐ ││ │
│ ││ └──┐│ └──┐│ │┌────┐│ └┘ │┌─────┘ │┌──┘ └┘ ││ ││ ││ ││ ││ ││ └──┐│ ││ │┌─────┘ ││ ││ │
│ │└──┐ │└────┘│ ││ ┌──┘└────┘│ ┌───┐ ││ ┌─────┘└─┘│ ││ ││ ││ ││ ┌┐ │└─┘│ ││ ┌─────┘│ ││ │
│ └──┐│ └──────┘ ││ └──┐┌─────┘ │┌──┘ ││ └──┐┌────┐│ └┘ ││ └┘ ││ ││ └──┐│ ││ │┌────┐│ └┘ │
│ ┌┐ │└──────────┘│ ┌┐ ││ ┌┐ ┌──┘└────┘│ ┌──┘│ ┌┐ │└──┐ │└────┘└─┘└──┐ ││ ││ ││ ┌┐ │└──┐ │
│ ││ └─────┐┌─────┘ ││ └┘ ││ └────────┐│ │┌──┘ ││ └──┐│ └────────┐┌──┘ ││ └┘ ││ ││ │┌──┘ │
│ │└─────┐ │└─────┐ │└────┘└────────┐ ││ ││ ┌──┘└──┐ ││ ┌──────┐ ││ ┌┐ │└────┘│ ││ ││ ┌──┘
│ │┌────┐│ └─────┐│ │┌─────────────┐│ ││ ││ │┌────┐│ ││ │┌────┐│ └┘ ││ └──┐┌──┘ ││ └┘ │┌─┐
│ ││ ┌──┘└─────┐ ││ │└───────────┐ ││ ││ ││ ││ ┌┐ ││ ││ ││ ┌┐ │└──┐ │└────┘│ ┌──┘└────┘│ │
│ ││ └────────┐│ ││ │┌──────────┐│ ││ └┘ ││ └┘ ││ ││ ││ ││ ││ └──┐│ │┌────┐│ │┌─┐┌─────┘ │
│ │└────────┐ ││ ││ ││ ┌──────┐ ││ │└────┘└────┘│ ││ │└─┘│ │└──┐ │└─┘│ ┌┐ ││ ││ ││ ┌───┐ │
│ └─────────┘ ││ ││ └┘ │┌────┐│ ││ └─────┐┌─┐┌──┘ ││ └───┘ │┌─┐│ └───┘ ││ └┘ ││ ││ └──┐│ │
└─────────────┘│ │└────┘│ ┌┐ ││ │└──┐ ┌┐ ││ ││ ┌──┘└───────┘│ │└───────┘└────┘│ │└──┐ ││ │
┌─────────────┐│ └──┐┌──┘ ││ ││ └───┘ ││ └┘ ││ └──┐┌────────┘ │┌────┐┌────────┘ │┌──┘ ││ │
│ ┌─────────┐ │└──┐ ││ ┌──┘│ │└───────┘└──┐ │└──┐ ││ ┌────────┘│ ┌┐ ││ ┌───┐ ┌┐ ││ ┌──┘│ │
│ └──┐┌────┐│ └───┘ ││ └──┐│ │┌───────┐┌──┘ │┌─┐│ ││ │┌────┐┌──┘ ││ └┘ │┌─┐│ ││ ││ │┌──┘ │
│ ┌┐ ││ ┌──┘│ ┌─────┘└──┐ ││ ││ ┌┐ ┌──┘│ ┌──┘│ ││ ││ ││ ┌┐ ││ ┌──┘└────┘│ ││ │└─┘│ ││ ┌──┘
│ ││ ││ └───┘ │┌────┐┌──┘ ││ └┘ ││ └───┘ │┌──┘ ││ ││ ││ ││ └┘ │┌────────┘ ││ └───┘ ││ └──┐
└─┘│ │└───────┘│ ┌┐ ││ ┌──┘└────┘│ ┌─────┘│ ┌┐ ││ ││ ││ │└────┘│ ┌───┐ ┌──┘└───────┘└──┐ │
┌──┘ │┌───────┐│ ││ ││ │┌───────┐│ │┌─────┘ ││ ││ ││ ││ └─────┐│ └──┐│ └─────┐┌───────┐│ │
│ ┌──┘│ ┌───┐ ││ ││ │└─┘│ ┌───┐ ││ ││ ┌─────┘│ ││ ││ │└─────┐ ││ ┌──┘└──┐ ┌┐ ││ ┌───┐ ││ │
│ └───┘ │┌─┐│ └┘ ││ └──┐│ │┌──┘ ││ └┘ │┌────┐│ ││ ││ └─────┐│ ││ │┌─────┘ ││ ││ │┌─┐│ └┘ │
│ ┌─────┘│ │└────┘└──┐ ││ ││ ┌──┘└────┘│ ┌┐ ││ ││ ││ ┌─────┘│ ││ ││ ┌─────┘│ ││ ││ │└──┐ │
│ └─────┐│ └────────┐│ ││ ││ └────────┐│ ││ └┘ ││ ││ └─────┐│ ││ ││ │┌─────┘ ││ ││ └──┐│ │
└─────┐ ││ ┌──────┐ ││ ││ │└────────┐ ││ │└────┘│ │└─────┐ ││ ││ ││ ││ ┌─────┘│ ││ ┌┐ ││ │
┌────┐│ └┘ │┌─┐┌──┘ ││ └┘ │┌───────┐│ ││ └─────┐│ │┌────┐│ └┘ ││ ││ ││ │┌─────┘ ││ ││ ││ │
│ ┌┐ │└────┘│ ││ ┌──┘└────┘│ ┌┐ ┌──┘│ │└───────┘│ ││ ┌┐ ││ ┌──┘└─┘│ ││ ││ ┌─────┘└─┘│ ││ │
│ ││ └─────┐│ └┘ │┌────────┘ ││ └──┐│ └────────┐│ ││ ││ ││ └──────┘ ││ ││ └─────┐┌──┘ ││ │
│ │└─────┐ ││ ┌──┘└──────────┘└──┐ │└────────┐ ││ ││ ││ │└──────────┘└─┘└─────┐ ││ ┌──┘│ │
│ └──┐┌─┐│ ││ └────────┐┌───────┐│ └────────┐│ ││ └┘ ││ │┌────────────────┐┌──┘ ││ └──┐│ │
└──┐ ││ ││ │└────────┐ ││ ┌───┐ ││ ┌──────┐ ││ │└────┘│ ││ ┌────────────┐ ││ ┌──┘│ ┌┐ ││ │
┌──┘ └┘ ││ └─────────┘ └┘ │┌──┘ └┘ │┌─────┘ ││ └──────┘ └┘ │┌───────────┘ └┘ │┌──┘ ││ └┘ │
└───────┘└────────────────┘└───────┘└───────┘└─────────────┘└────────────────┘└────┘└────┘