┌─┐┌───────┐┌────┐┌────┐┌─────────────────────────┐┌───────┐
│ │└──┐ ┌┐ ││ ┌┐ ││ ┌┐ │└──┐ ┌───────────────┐ ┌┐ │└──┐ ┌┐ │
│ └──┐│ ││ └┘ ││ └┘ ││ └──┐│ └────────┐┌────┐│ ││ └──┐│ ││ │
└──┐ ││ ││ ┌──┘└────┘└──┐ │└──────────┘│ ┌┐ ││ │└──┐ ││ ││ │
┌─┐│ ││ ││ │┌───────┐┌─┐│ │┌───────────┘ ││ ││ │┌─┐│ ││ ││ │
│ ││ ││ │└─┘│ ┌───┐ ││ ││ ││ ┌───────────┘│ ││ ││ ││ ││ ││ │
│ ││ ││ └───┘ └──┐│ ││ ││ └┘ │┌────┐┌────┐│ └┘ ││ ││ └┘ ││ │
│ ││ │└──────────┘│ ││ │└────┘│ ┌──┘│ ┌┐ │└────┘│ │└────┘│ │
│ ││ └────────────┘ ││ └──┐┌──┘ └──┐│ ││ └──┐┌──┘ └──────┘ │
│ │└────────────────┘│ ┌┐ ││ ┌───┐ ││ │└──┐ ││ ┌───────────┘
│ └────────┐┌────────┘ ││ ││ └──┐│ └┘ │┌─┐│ └┘ │┌──────────┐
└──┐ ┌───┐ ││ ┌───┐ ┌──┘└─┘└──┐ │└────┘│ │└────┘└────────┐ │
┌──┘ │┌──┘ ││ └──┐│ │┌───────┐│ │┌─────┘ └──┐┌──────────┐│ │
│ ┌──┘│ ┌──┘└──┐ ││ ││ ┌───┐ ││ │└──┐ ┌───┐ │└──┐ ┌───┐ ││ │
│ └──┐│ └─────┐│ ││ ││ │┌─┐│ ││ └───┘ │┌─┐│ └──┐│ └──┐│ ││ │
│ ┌┐ │└─────┐ │└─┘│ ││ ││ ││ │└───────┘│ │└──┐ │└──┐ ││ ││ │
│ ││ │┌────┐│ └──┐│ └┘ └┘ ││ └─────┐┌──┘ └──┐│ └──┐│ ││ └┘ │
│ ││ │└──┐ │└──┐ │└───────┘└──┐ ┌┐ ││ ┌─────┘└──┐ ││ │└──┐ │
│ ││ └──┐│ └──┐│ └────────────┘ ││ └┘ │┌───────┐│ └┘ │┌─┐│ │
└─┘└──┐ ││ ┌──┘│ ┌──────────────┘└────┘│ ┌───┐ │└────┘│ ││ │
┌─────┘ ││ └───┘ │┌───────┐┌───────────┘ │┌─┐│ └──┐┌──┘ └┘ │
│ ┌─────┘│ ┌─────┘│ ┌───┐ ││ ┌───────────┘│ │└──┐ ││ ┌─────┘
│ └─────┐│ └──┐┌──┘ │┌─┐│ ││ └──┐┌────────┘ └──┐│ ││ └──┐┌─┐
└─────┐ │└──┐ ││ ┌──┘│ ││ │└──┐ ││ ┌───┐ ┌─────┘│ │└──┐ ││ │
┌────┐│ └──┐│ ││ └───┘ ││ └──┐│ ││ └──┐│ └─────┐│ └──┐│ ││ │
│ ┌┐ │└──┐ │└─┘└─────┐ │└──┐ ││ │└────┘└─────┐ ││ ┌┐ ││ ││ │
│ ││ └──┐│ └────────┐│ │┌─┐│ ││ └────────────┘ ││ ││ ││ ││ │
│ │└──┐ ││ ┌┐ ┌───┐ ││ ││ ││ │└───────────┐ ┌──┘│ ││ ││ ││ │
│ └──┐│ ││ ││ └──┐│ ││ └┘ ││ └────────────┘ │┌──┘ ││ ││ ││ │
│ ┌┐ ││ ││ │└──┐ │└─┘└──┐ │└───────────┐ ┌──┘│ ┌──┘└─┘│ ││ │
│ ││ ││ ││ │┌─┐│ └─────┐│ └──┐┌─┐┌────┐│ └──┐│ │┌─────┘ ││ │
└─┘│ ││ ││ ││ │└──┐ ┌┐ │└──┐ ││ ││ ┌┐ │└────┘│ ││ ┌─────┘│ │
┌──┘ ││ ││ └┘ │┌──┘ ││ │┌──┘ ││ ││ ││ └──────┘ ││ │┌─────┘ │
│ ┌──┘│ │└────┘│ ┌┐ │└─┘│ ┌──┘│ ││ │└──────────┘│ ││ ┌┐ ┌──┘
│ └──┐│ └──────┘ ││ │┌──┘ │┌──┘ ││ └─────┐┌────┐│ ││ ││ └──┐
│ ┌┐ │└──────────┘└─┘│ ┌──┘│ ┌──┘└─────┐ ││ ┌┐ ││ │└─┘└──┐ │
│ ││ └──────────────┐│ │┌──┘ └──┐┌─────┘ ││ ││ └┘ │┌─────┘ │
│ │└──────────────┐ ││ │└─────┐ ││ ┌─────┘│ │└────┘│ ┌───┐ │
│ └──────────────┐│ └┘ └──────┘ ││ └──────┘ └──────┘ │┌──┘ │
└────────────────┘└─────────────┘└───────────────────┘└────┘