┌────┐┌───────┐┌──────────┐┌───────────────────┐┌───────┐┌────────────────┐
└──┐ │└──┐ ┌┐ ││ ┌──────┐ │└────────┐ ┌───┐ ┌┐ ││ ┌───┐ │└───────────┐ ┌┐ │
┌─┐│ └───┘ ││ ││ │┌────┐│ │┌───────┐│ │┌──┘ ││ └┘ │┌─┐│ └─────┐┌─────┘ ││ │
│ │└───────┘│ ││ │└──┐ ││ ││ ┌───┐ │└─┘│ ┌──┘└────┘│ │└─────┐ ││ ┌─────┘│ │
│ └────────┐│ └┘ │┌──┘ ││ ││ │┌──┘ └──┐│ │┌────────┘ │┌─────┘ ││ │┌────┐│ │
└────────┐ │└────┘│ ┌┐ ││ ││ │└─────┐ ││ ││ ┌┐ ┌─────┘│ ┌─────┘│ │└──┐ ││ │
┌────────┘ └──────┘ ││ ││ ││ └─────┐│ ││ ││ ││ │┌─────┘ │┌─┐┌──┘ └──┐│ └┘ │
│ ┌┐ ┌──────────────┘└─┘│ │└─────┐ ││ ││ │└─┘│ ││ ┌─────┘│ ││ ┌───┐ ││ ┌──┘
│ ││ │┌─────────────┐┌──┘ │┌─────┘ ││ ││ │┌──┘ ││ │┌─────┘ ││ └──┐│ ││ │┌─┐
│ │└─┘│ ┌─────────┐ ││ ┌──┘│ ┌─────┘│ ││ ││ ┌──┘│ ││ ┌───┐ │└──┐ ││ ││ ││ │
│ └───┘ │┌────┐┌──┘ ││ │┌──┘ │┌────┐│ └┘ ││ └───┘ ││ └──┐│ └──┐│ ││ ││ └┘ │
│ ┌─────┘│ ┌──┘│ ┌┐ ││ │└──┐ ││ ┌──┘└────┘│ ┌─────┘│ ┌──┘│ ┌──┘│ ││ │└──┐ │
│ └──────┘ │┌──┘ ││ ││ └───┘ ││ │┌────────┘ │┌────┐│ │┌──┘ │┌──┘ ││ │┌─┐│ │
└────────┐ ││ ┌──┘└─┘└───────┘│ ││ ┌────────┘│ ┌──┘│ ││ ┌──┘│ ┌──┘│ ││ ││ │
┌────────┘ ││ │┌──────────────┘ ││ └─────┐┌──┘ └──┐│ ││ │┌──┘ │┌──┘ ││ └┘ │
│ ┌────────┘│ ││ ┌────────────┐ │└─────┐ │└──┐ ┌┐ ││ ││ ││ ┌──┘│ ┌──┘│ ┌──┘
│ └──┐┌─────┘ ││ └──┐┌───────┐│ └─────┐│ └──┐│ ││ └┘ ││ └┘ │┌──┘ │┌──┘ └──┐
└──┐ ││ ┌───┐ │└──┐ │└─────┐ │└─────┐ │└──┐ ││ │└────┘│ ┌──┘│ ┌──┘└───────┘
┌─┐│ ││ │┌──┘ └──┐│ └──────┘ │┌────┐│ └──┐│ ││ │┌────┐│ │┌──┘ │┌──────────┐
│ ││ ││ │└─────┐ │└────────┐ ││ ┌┐ │└──┐ ││ │└─┘│ ┌┐ │└─┘│ ┌──┘│ ┌──────┐ │
│ └┘ ││ └──┐┌──┘ │┌────────┘ ││ ││ └──┐│ └┘ │┌──┘ ││ └──┐│ │┌──┘ │┌─────┘ │
└────┘│ ┌┐ ││ ┌──┘│ ┌────────┘│ ││ ┌──┘└────┘│ ┌──┘└──┐ ││ ││ ┌──┘│ ┌───┐ │
┌────┐│ ││ ││ │┌──┘ │┌───────┐│ ││ └─────────┘ │┌─────┘ └┘ ││ └──┐│ └──┐│ │
│ ┌┐ │└─┘│ ││ ││ ┌──┘│ ┌───┐ ││ │└────────┐ ┌┐ │└────────┐ ││ ┌──┘└──┐ ││ │
│ ││ └──┐│ ││ ││ └──┐│ └──┐│ ││ └──┐┌────┐│ ││ └─────┐┌─┐│ ││ │┌─────┘ ││ │
│ │└──┐ ││ ││ │└──┐ │└──┐ ││ │└────┘│ ┌┐ ││ │└─────┐ ││ ││ ││ ││ ┌─────┘│ │
│ └──┐│ └┘ ││ └──┐│ │┌──┘ ││ └──────┘ ││ ││ │┌─────┘ ││ └┘ ││ ││ └──┐┌─┐│ │
│ ┌┐ │└────┘└────┘│ ││ ┌──┘└──────────┘│ ││ ││ ┌─────┘│ ┌──┘│ │└──┐ ││ ││ │
│ ││ └────────────┘ ││ └──┐┌───────┐┌──┘ ││ ││ └──┐┌─┐│ └──┐│ │┌──┘ ││ ││ │
│ │└────────────────┘└──┐ ││ ┌───┐ ││ ┌──┘└─┘└──┐ ││ ││ ┌──┘│ ││ ┌──┘│ ││ │
│ │┌────────────────────┘ ││ └──┐│ └┘ │┌────────┘ ││ ││ │┌──┘ ││ │┌──┘ ││ │
│ ││ ┌────────────────────┘└──┐ │└────┘│ ┌────────┘│ ││ ││ ┌──┘│ │└──┐ ││ │
│ └┘ │┌─────────────┐┌───────┐│ │┌────┐│ └──┐┌─────┘ └┘ ││ │┌─┐│ └──┐│ └┘ │
└────┘└──┐ ┌──────┐ ││ ┌───┐ ││ ││ ┌┐ ││ ┌┐ ││ ┌────────┘│ ││ │└──┐ │└────┘
┌─┐┌─────┘ │┌────┐│ └┘ │┌─┐│ ││ ││ ││ ││ ││ ││ └──┐┌────┐│ └┘ │┌─┐│ └─────┐
│ ││ ┌┐ ┌──┘│ ┌┐ │└────┘│ ││ ││ ││ ││ ││ ││ │└────┘│ ┌┐ │└──┐ ││ │└─────┐ │
│ ││ ││ └──┐│ ││ └──┐┌──┘ └┘ ││ └┘ ││ ││ ││ └──────┘ ││ │┌──┘ ││ └─────┐│ │
│ ││ │└──┐ ││ ││ ┌──┘│ ┌─────┘└────┘│ │└─┘│ ┌────────┘│ ││ ┌──┘└──┐ ┌┐ ││ │
│ └┘ └──┐│ ││ ││ └───┘ │┌──────────┐│ └──┐│ └─────┐┌──┘ ││ └──┐┌──┘ ││ ││ │
│ ┌─────┘│ │└─┘└──┐ ┌──┘│ ┌────────┘└──┐ │└─────┐ ││ ┌──┘└──┐ ││ ┌──┘└─┘│ │
│ │┌─────┘ │┌────┐│ └──┐│ │┌──────────┐│ │┌────┐│ ││ └──────┘ └┘ │┌────┐│ │
│ ││ ┌┐ ┌──┘│ ┌┐ │└──┐ ││ ││ ┌───┐ ┌┐ ││ ││ ┌──┘│ │└─────────────┘│ ┌┐ ││ │
│ ││ ││ │┌──┘ ││ │┌─┐│ ││ └┘ │┌──┘ ││ ││ ││ └───┘ │┌───────┐┌────┐│ ││ ││ │
└─┘│ ││ ││ ┌──┘│ ││ ││ │└────┘│ ┌──┘└─┘│ ││ ┌─────┘│ ┌───┐ ││ ┌┐ ││ ││ ││ │
┌──┘ ││ ││ │┌─┐│ ││ └┘ └──────┘ │┌────┐│ ││ │┌─────┘ │┌──┘ ││ ││ ││ ││ └┘ │
│ ┌──┘└─┘│ ││ ││ │└─────────────┘│ ┌┐ ││ ││ ││ ┌─────┘│ ┌──┘│ ││ ││ │└────┘
│ │┌────┐│ └┘ ││ └──┐┌───────────┘ ││ └┘ ││ ││ └──┐┌──┘ │┌──┘ ││ ││ └─────┐
│ ││ ┌┐ │└──┐ │└──┐ ││ ┌───────────┘└────┘└─┘└──┐ ││ ┌──┘│ ┌──┘│ │└─────┐ │
│ └┘ ││ └───┘ └──┐│ └┘ └────────────────────────┘ ││ └───┘ │┌──┘ └──────┘ │
└────┘└──────────┘└───────────────────────────────┘└───────┘└─────────────┘