┌─┐┌──────────┐┌──────────┐┌───────┐┌────────────────┐┌───────┐┌──────────┐
│ ││ ┌┐ ┌─────┘│ ┌┐ ┌┐ ┌──┘│ ┌───┐ ││ ┌──────┐ ┌┐ ┌┐ ││ ┌─────┘│ ┌──────┐ │
│ ││ ││ └─────┐│ ││ ││ │┌──┘ └──┐│ └┘ │┌────┐│ ││ ││ ││ │┌─────┘ └──┐┌──┘ │
│ │└─┘└─────┐ ││ ││ │└─┘│ ┌─────┘└────┘│ ┌┐ │└─┘│ ││ ││ ││ ┌────────┘│ ┌┐ │
│ └────────┐│ └┘ ││ └───┘ │┌───────────┘ ││ └───┘ ││ ││ ││ │┌────┐┌──┘ ││ │
└────────┐ │└────┘└───────┘│ ┌───────────┘└───────┘│ ││ ││ │└──┐ ││ ┌──┘│ │
┌────┐┌──┘ │┌───────┐┌─────┘ │┌───────┐┌───────────┘ ││ └┘ └───┘ ││ │┌─┐│ │
│ ┌──┘│ ┌──┘│ ┌───┐ ││ ┌─────┘│ ┌───┐ ││ ┌───────────┘└──────────┘│ ││ ││ │
│ └──┐│ │┌──┘ └──┐│ └┘ │┌────┐│ └──┐│ ││ │┌─┐┌──────────┐┌───────┐│ ││ └┘ │
└──┐ ││ ││ ┌───┐ ││ ┌──┘│ ┌┐ │└──┐ ││ ││ ││ ││ ┌───┐ ┌┐ ││ ┌───┐ ││ ││ ┌──┘
┌──┘ ││ ││ └──┐│ ││ │┌──┘ ││ └───┘ ││ ││ ││ ││ │┌─┐│ ││ └┘ │┌─┐│ └┘ ││ │┌─┐
│ ┌┐ ││ │└────┘│ ││ ││ ┌──┘└───────┘│ ││ ││ ││ ││ ││ │└────┘│ │└────┘│ ││ │
│ ││ ││ │┌─────┘ ││ ││ └───────────┐│ ││ ││ ││ └┘ ││ └──┐┌──┘ └─────┐│ ││ │
│ ││ ││ ││ ┌─────┘└─┘└─────┐ ┌─────┘│ ││ ││ │└──┐ │└──┐ ││ ┌┐ ┌─────┘│ ││ │
│ ││ ││ ││ └──┐┌───────────┘ │┌─────┘ ││ ││ │┌──┘ │┌──┘ ││ ││ └─────┐│ └┘ │
│ │└─┘│ ││ ┌┐ ││ ┌───────────┘│ ┌─────┘│ ││ ││ ┌──┘│ ┌──┘└─┘└─────┐ │└──┐ │
│ └──┐│ ││ ││ └┘ └──┐┌─┐┌─────┘ │┌────┐│ ││ └┘ │┌─┐│ └───────────┐│ └──┐│ │
│ ┌┐ ││ │└─┘└─────┐ ││ ││ ┌─────┘└──┐ ││ ││ ┌──┘│ │└───────────┐ ││ ┌┐ ││ │
│ ││ └┘ │┌────┐┌──┘ └┘ ││ └──┐┌─────┘ ││ ││ └──┐│ └───────────┐│ ││ ││ └┘ │
│ │└────┘│ ┌┐ ││ ┌─────┘└──┐ │└──┐ ┌──┘│ │└──┐ │└──┐ ┌────────┘│ │└─┘│ ┌──┘
│ └──────┘ ││ ││ └──┐┌────┐│ └──┐│ └───┘ │┌──┘ └───┘ │┌───────┐│ └──┐│ │┌─┐
└──────────┘│ │└──┐ ││ ┌┐ │└──┐ ││ ┌─────┘└──────────┘│ ┌───┐ │└──┐ ││ ││ │
┌───────┐┌──┘ │┌──┘ ││ ││ └───┘ ││ └──┐┌─────────────┐│ │┌─┐│ └───┘ ││ ││ │
│ ┌───┐ ││ ┌──┘│ ┌──┘│ │└───────┘└──┐ ││ ┌┐ ┌──────┐ ││ ││ │└───────┘│ ││ │
│ │┌─┐│ └┘ │┌──┘ │┌─┐│ └──┐┌───────┐│ ││ ││ └─────┐│ └┘ ││ └────────┐│ ││ │
│ ││ │└────┘│ ┌──┘│ │└──┐ ││ ┌───┐ ││ ││ │└─────┐ │└────┘│ ┌──────┐ ││ ││ │
│ ││ └──┐┌──┘ │┌──┘ └──┐│ ││ └──┐│ └┘ ││ │┌─────┘ │┌─┐┌──┘ │┌─────┘ ││ └┘ │
│ │└──┐ ││ ┌──┘└─────┐ ││ │└──┐ │└────┘└─┘│ ┌─────┘│ ││ ┌──┘│ ┌─────┘└──┐ │
│ └──┐│ ││ └────────┐│ ││ │┌─┐│ └──┐┌─────┘ │┌─────┘ ││ │┌──┘ │┌────────┘ │
└──┐ ││ │└────────┐ ││ ││ ││ │└──┐ ││ ┌┐ ┌──┘│ ┌┐ ┌──┘│ ││ ┌┐ ││ ┌────────┘
┌──┘ ││ └─────────┘ └┘ ││ ││ └──┐│ ││ ││ │┌──┘ ││ │┌──┘ ││ ││ ││ └──┐┌────┐
│ ┌──┘└────────────────┘│ ││ ┌┐ ││ │└─┘│ ││ ┌──┘│ ││ ┌──┘│ │└─┘└──┐ │└──┐ │
│ └──────────────┐┌─────┘ ││ ││ ││ └───┘ ││ └──┐│ ││ └──┐│ └─────┐│ └───┘ │
└──────────────┐ ││ ┌─────┘│ ││ │└───────┘│ ┌┐ │└─┘└──┐ │└─────┐ │└─────┐ │
┌───────┐┌─────┘ ││ └─────┐│ ││ └─────────┘ ││ │┌────┐│ └──┐┌─┐│ └─────┐│ │
└──┐ ┌──┘│ ┌─────┘│ ┌───┐ ││ │└─────────────┘│ ││ ┌┐ │└──┐ ││ │└──┐ ┌──┘│ │
┌──┘ │┌──┘ │┌────┐│ │┌──┘ ││ └──────────────┐│ └┘ ││ └──┐│ └┘ │┌─┐│ └───┘ │
│ ┌──┘│ ┌──┘│ ┌┐ │└─┘│ ┌──┘└──────────────┐ │└────┘│ ┌──┘└──┐ ││ │└───────┘
│ │┌──┘ │┌──┘ ││ └───┘ │┌─┐┌───────┐┌─────┘ │┌────┐│ └──────┘ ││ └────────┐
│ ││ ┌──┘└──┐ │└───────┘│ ││ ┌┐ ┌──┘│ ┌─────┘│ ┌──┘└──────────┘└─────┐ ┌┐ │
│ └┘ │┌─────┘ │┌───────┐│ └┘ ││ └──┐│ │┌─────┘ └───────────┐┌───────┐│ ││ │
│ ┌──┘│ ┌─────┘└─────┐ ││ ┌──┘└──┐ ││ ││ ┌────────────┐ ┌┐ │└──┐ ┌┐ │└─┘│ │
│ │┌──┘ └──┐┌────────┘ ││ │┌────┐│ └┘ ││ └───────────┐│ ││ │┌──┘ ││ │┌──┘ │
│ │└─────┐ ││ ┌──────┐ ││ ││ ┌──┘└────┘└─────────────┘│ ││ ││ ┌──┘│ ││ ┌┐ │
│ │┌─────┘ ││ │┌─────┘ ││ ││ └────────────────────┐┌──┘ ││ ││ └──┐│ └┘ ││ │
│ ││ ┌─────┘│ │└──┐ ┌──┘│ │└─────┐ ┌───┐ ┌──────┐ ││ ┌──┘│ ││ ┌┐ │└────┘│ │
│ ││ │┌────┐│ └──┐│ └──┐│ └─────┐│ └──┐│ └──┐┌─┐│ └┘ │┌──┘ ││ ││ └─────┐│ │
│ ││ ││ ┌──┘│ ┌┐ │└────┘└─────┐ │└────┘└──┐ ││ │└────┘│ ┌──┘└─┘└─────┐ ││ │
│ └┘ ││ └───┘ ││ └────────────┘ └─────────┘ ││ └──────┘ └────────────┘ ││ │
└────┘└───────┘└────────────────────────────┘└─────────────────────────┘└─┘