┌────┐┌──────────┐┌─────────────┐┌───────────────────┐┌────┐┌───────┐┌────┐
└──┐ │└────────┐ ││ ┌──────┐ ┌┐ │└──┐ ┌────────────┐ ││ ┌┐ ││ ┌┐ ┌┐ ││ ┌┐ │
┌─┐│ └────────┐│ └┘ │┌─┐┌──┘ ││ └───┘ │┌───────┐┌──┘ ││ ││ ││ ││ ││ └┘ ││ │
│ │└────────┐ │└──┐ ││ ││ ┌──┘└───────┘│ ┌─────┘│ ┌──┘│ │└─┘│ ││ │└────┘└─┘
│ └────────┐│ └──┐│ └┘ ││ │┌───────────┘ └──────┘ │┌──┘ └───┘ ││ └────────┐
└─────┐ ┌──┘└──┐ ││ ┌──┘│ ││ ┌────────────────────┘└─────┐ ┌──┘└─────┐ ┌┐ │
┌─────┘ │┌────┐│ ││ │┌──┘ ││ └──────────────┐┌──────────┐│ │┌───────┐│ ││ │
│ ┌─────┘│ ┌┐ ││ │└─┘│ ┌──┘└──────────────┐ ││ ┌───┐ ┌┐ │└─┘│ ┌───┐ ││ ││ │
│ └──────┘ ││ └┘ │┌──┘ │┌─┐┌───────┐┌─────┘ ││ │┌──┘ ││ │┌──┘ │┌─┐│ ││ ││ │
│ ┌────────┘└────┘│ ┌──┘│ ││ ┌┐ ┌┐ ││ ┌─────┘│ ││ ┌──┘│ ││ ┌──┘│ ││ │└─┘│ │
│ │┌───────┐┌─────┘ │┌──┘ ││ ││ ││ ││ │┌─────┘ ││ └──┐│ ││ │┌──┘ └┘ │┌──┘ │
│ ││ ┌───┐ ││ ┌─────┘│ ┌──┘│ ││ │└─┘│ ││ ┌─────┘└──┐ ││ ││ ││ ┌─────┘│ ┌┐ │
│ ││ └──┐│ ││ └─────┐│ └───┘ ││ └──┐│ ││ └────────┐│ ││ └┘ ││ └──────┘ ││ │
│ │└──┐ ││ ││ ┌───┐ │└───────┘└──┐ ││ │└────────┐ ││ │└────┘└──────────┘│ │
│ └──┐│ ││ ││ └──┐│ └────────┐┌──┘ ││ └──┐┌────┐│ ││ │┌─┐┌─────────────┐│ │
└──┐ ││ ││ │└──┐ │└────────┐ ││ ┌──┘└──┐ ││ ┌┐ │└─┘│ ││ ││ ┌─────────┐ ││ │
┌─┐│ └┘ ││ │┌──┘ │┌────────┘ ││ └─────┐│ └┘ ││ └──┐│ ││ ││ └─────┐┌─┐│ └┘ │
│ │└────┘│ │└────┘│ ┌────────┘└──┐ ┌┐ │└────┘└──┐ ││ ││ │└─────┐ ││ │└────┘
│ └─────┐│ │┌─────┘ │┌───────────┘ ││ └──┐┌─────┘ ││ ││ │┌─────┘ ││ └──┐┌─┐
│ ┌─────┘│ ││ ┌─────┘│ ┌───┐ ┌─────┘└────┘│ ┌─────┘│ ││ ││ ┌─────┘│ ┌┐ ││ │
│ │┌────┐│ ││ └─────┐│ └──┐│ │┌───────┐┌──┘ │┌─────┘ ││ └┘ │┌─────┘ ││ ││ │
│ ││ ┌┐ ││ │└─────┐ │└──┐ ││ ││ ┌───┐ ││ ┌──┘│ ┌─────┘│ ┌──┘│ ┌─────┘│ ││ │
│ └┘ ││ ││ └─────┐│ │┌──┘ ││ ││ └──┐│ ││ │┌──┘ └──┐┌──┘ │┌─┐│ └─────┐│ ││ │
│ ┌──┘│ │└─────┐ ││ ││ ┌──┘│ │└──┐ ││ ││ ││ ┌───┐ │└──┐ ││ ││ ┌───┐ ││ ││ │
│ └──┐│ └─────┐│ └┘ ││ │┌──┘ │┌──┘ ││ └┘ ││ └──┐│ └──┐│ ││ └┘ └──┐│ ││ └┘ │
└──┐ ││ ┌─────┘└────┘│ │└────┘│ ┌──┘└────┘│ ┌──┘└──┐ ││ │└───────┘│ │└──┐ │
┌──┘ ││ └─────┐┌─────┘ └─────┐│ │┌────┐┌──┘ │┌─────┘ ││ └────────┐│ │┌─┐│ │
│ ┌──┘└─────┐ ││ ┌─────────┐ ││ ││ ┌┐ ││ ┌──┘│ ┌─────┘│ ┌──────┐ ││ ││ ││ │
│ └──┐┌────┐│ └┘ │┌───────┐│ ││ ││ ││ └┘ │┌──┘ │┌─────┘ │┌────┐│ └┘ ││ └┘ │
└──┐ ││ ┌┐ │└────┘└──┐ ┌┐ ││ ││ │└─┘└────┘│ ┌──┘│ ┌─────┘│ ┌┐ │└────┘└──┐ │
┌──┘ ││ ││ └─────────┘ ││ ││ ││ │┌───────┐│ │┌─┐│ │┌─────┘ ││ └────────┐│ │
│ ┌──┘│ │└─────┐ ┌─────┘│ ││ ││ ││ ┌───┐ ││ ││ ││ ││ ┌─────┘└────────┐ ││ │
│ │┌──┘ │┌────┐│ └──┐┌──┘ ││ ││ ││ │┌──┘ ││ ││ └┘ ││ └──┐┌─┐┌────────┘ ││ │
│ │└──┐ │└──┐ │└──┐ │└──┐ ││ ││ ││ ││ ┌──┘│ │└────┘└──┐ ││ ││ ┌────────┘│ │
│ └──┐│ └───┘ │┌─┐│ └──┐│ ││ └┘ ││ ││ └───┘ │┌────────┘ ││ ││ │┌────┐┌─┐│ │
└──┐ │└─────┐ ││ │└──┐ │└─┘└────┘│ │└───────┘│ ┌────────┘│ ││ ││ ┌┐ ││ ││ │
┌─┐│ └──┐┌──┘ ││ └──┐│ └────────┐│ └──┐┌────┐│ └─────────┘ ││ ││ ││ └┘ ││ │
│ │└──┐ ││ ┌──┘└──┐ │└─────┐ ┌┐ ││ ┌┐ ││ ┌┐ │└────────┐ ┌──┘│ ││ │└────┘│ │
│ └───┘ ││ └──────┘ │┌────┐│ ││ ││ ││ ││ ││ └────────┐│ │┌──┘ ││ └──┐┌──┘ │
│ ┌─────┘└────────┐ │└──┐ ││ ││ ││ ││ ││ │└─────┐ ┌──┘│ ││ ┌──┘└──┐ ││ ┌──┘
│ └──┐┌───────────┘ │┌──┘ ││ ││ ││ ││ └┘ │┌────┐│ └───┘ ││ └──┐┌──┘ ││ └──┐
└──┐ ││ ┌───────────┘│ ┌──┘│ ││ ││ │└────┘│ ┌──┘└─────┐ │└──┐ ││ ┌┐ │└──┐ │
┌──┘ ││ │┌────┐┌─────┘ │┌──┘ ││ ││ └──┐┌──┘ │┌───────┐│ └──┐│ ││ ││ └──┐│ │
│ ┌──┘│ ││ ┌┐ │└─────┐ ││ ┌──┘└─┘└──┐ │└──┐ ││ ┌───┐ ││ ┌──┘│ ││ │└────┘│ │
│ │┌──┘ ││ ││ └──────┘ ││ └─────────┘ └──┐│ ││ │┌──┘ ││ │┌──┘ ││ └──────┘ │
│ ││ ┌──┘│ ││ ┌────────┘│ ┌────────────┐ ││ ││ ││ ┌──┘└─┘│ ┌──┘│ ┌────────┘
│ ││ └───┘ ││ │┌───────┐│ └──┐┌───────┐│ └┘ ││ ││ │┌────┐│ │┌─┐│ │┌───────┐
│ │└───────┘└─┘│ ┌───┐ │└────┘│ ┌───┐ │└────┘│ ││ ││ ┌┐ ││ ││ ││ ││ ┌───┐ │
│ └────────────┘ │┌──┘ └──────┘ │┌──┘ └──────┘ ││ └┘ ││ └┘ ││ └┘ └┘ │┌──┘ │
└────────────────┘└─────────────┘└─────────────┘└────┘└────┘└───────┘└────┘