┌───────┐┌───────┐┌──────────┐┌───────────────────────────────┐┌─┐┌───────┐
└─────┐ ││ ┌───┐ ││ ┌───┐ ┌──┘│ ┌───┐ ┌─────────────────────┐ ││ ││ ┌┐ ┌──┘
┌────┐│ ││ └──┐│ └┘ │┌──┘ │┌──┘ │┌──┘ │┌────┐┌─────────────┐│ ││ └┘ ││ └──┐
│ ┌┐ ││ │└──┐ │└────┘│ ┌┐ ││ ┌──┘│ ┌──┘└──┐ ││ ┌──────┐ ┌──┘│ │└────┘└──┐ │
│ ││ └┘ │┌──┘ │┌────┐│ ││ ││ └──┐│ └──┐┌──┘ ││ └──┐┌─┐│ │┌──┘ │┌────────┘ │
│ │└────┘└──┐ ││ ┌┐ ││ │└─┘└──┐ │└──┐ ││ ┌──┘└──┐ ││ ││ ││ ┌──┘│ ┌──────┐ │
│ └──┐┌────┐│ └┘ ││ ││ └──────┘ │┌──┘ ││ └─────┐│ ││ ││ └┘ │┌──┘ └──┐┌──┘ │
└──┐ ││ ┌┐ │└────┘└─┘│ ┌────────┘│ ┌──┘└─────┐ ││ ││ │└────┘└─────┐ │└────┘
┌─┐│ └┘ ││ └────────┐│ └─────┐┌──┘ │┌────────┘ ││ ││ └───────────┐│ └─────┐
│ │└────┘└────────┐ │└──┐ ┌──┘│ ┌──┘│ ┌────────┘│ │└─────┐ ┌───┐ │└─────┐ │
│ │┌─────────────┐│ └──┐│ │┌──┘ │┌──┘ │┌───────┐│ └──────┘ │┌─┐│ └──────┘ │
│ ││ ┌──────┐ ┌┐ │└──┐ ││ ││ ┌──┘└──┐ ││ ┌───┐ │└──────────┘│ │└────────┐ │
│ ││ └──┐┌─┐│ ││ │┌──┘ ││ ││ │┌─────┘ ││ │┌─┐│ └────────────┘ └──┐┌────┐│ │
│ │└──┐ ││ ││ │└─┘│ ┌──┘│ ││ ││ ┌┐ ┌──┘│ ││ │└─────┐ ┌───────────┘│ ┌┐ ││ │
│ │┌──┘ ││ ││ └──┐│ └──┐│ ││ ││ ││ └──┐│ └┘ └──┐┌─┐│ └────────┐┌──┘ ││ └┘ │
│ ││ ┌──┘│ │└──┐ │└──┐ │└─┘│ ││ │└──┐ │└─────┐ ││ │└────────┐ ││ ┌──┘└────┘
│ └┘ └───┘ └──┐│ └──┐│ └───┘ ││ │┌──┘ │┌────┐│ ││ └────────┐│ └┘ │┌────┐┌─┐
└─────────────┘│ ┌──┘└───────┘│ ││ ┌──┘│ ┌┐ ││ │└────────┐ │└────┘│ ┌┐ ││ │
┌───────┐┌────┐│ └───────────┐│ ││ │┌──┘ ││ ││ └────────┐│ └──────┘ ││ └┘ │
│ ┌───┐ ││ ┌┐ │└──┐ ┌──────┐ │└─┘│ ││ ┌──┘│ │└────────┐ │└─────┐ ┌──┘└──┐ │
│ └──┐│ └┘ ││ └───┘ │┌────┐│ └──┐│ └┘ │┌──┘ └──┐┌─────┘ │┌────┐│ │┌────┐│ │
└──┐ │└──┐ │└───────┘│ ┌┐ │└──┐ ││ ┌──┘│ ┌─────┘│ ┌─────┘│ ┌┐ ││ ││ ┌──┘│ │
┌──┘ │┌──┘ │┌────────┘ ││ │┌─┐│ ││ │┌──┘ │┌────┐│ │┌─────┘ ││ └┘ ││ │┌──┘ │
│ ┌──┘└────┘│ ┌────────┘│ ││ ││ │└─┘│ ┌──┘│ ┌┐ ││ ││ ┌─────┘└────┘│ ││ ┌──┘
│ └────────┐│ │┌────┐┌──┘ ││ └┘ └───┘ │┌──┘ ││ └┘ ││ └─────┐┌─────┘ ││ └──┐
│ ┌──────┐ ││ │└──┐ ││ ┌──┘│ ┌──────┐ ││ ┌──┘└────┘└─────┐ │└─────┐ │└──┐ │
│ └─────┐│ ││ │┌──┘ ││ │┌──┘ │┌────┐│ ││ │┌────┐┌────────┘ │┌────┐│ └──┐│ │
│ ┌─────┘│ ││ ││ ┌┐ ││ ││ ┌──┘│ ┌┐ │└─┘│ ││ ┌┐ │└──┐ ┌─────┘│ ┌┐ ││ ┌┐ ││ │
│ │┌─────┘ ││ ││ ││ ││ ││ │┌──┘ ││ └──┐│ └┘ ││ └───┘ │┌─────┘ ││ └┘ ││ ││ │
└─┘│ ┌┐ ┌──┘│ ││ ││ ││ │└─┘│ ┌──┘└──┐ │└────┘└───────┘│ ┌─────┘└──┐ │└─┘│ │
┌──┘ ││ │┌──┘ ││ ││ ││ └───┘ └──┐┌─┐│ │┌───────┐┌─────┘ │┌────────┘ │┌──┘ │
│ ┌──┘└─┘│ ┌──┘│ │└─┘└────────┐ ││ ││ ││ ┌───┐ ││ ┌───┐ ││ ┌──────┐ ││ ┌──┘
│ │┌─────┘ │┌──┘ └──┐┌───────┐│ └┘ ││ ││ └──┐│ └┘ └──┐│ ││ │┌────┐│ ││ └──┐
│ ││ ┌─────┘│ ┌───┐ ││ ┌───┐ │└────┘│ │└──┐ │└───────┘│ │└─┘│ ┌┐ │└─┘└──┐ │
│ └┘ │┌─────┘ └──┐│ ││ └──┐│ └──────┘ └──┐│ │┌────┐┌──┘ │┌──┘ ││ └──────┘ │
│ ┌──┘└──────────┘│ │└──┐ │└───────────┐ ││ ││ ┌──┘│ ┌──┘│ ┌──┘└──────────┘
│ └──┐┌──────────┐│ └──┐│ └──┐┌─┐┌────┐│ ││ ││ └──┐│ └──┐│ └─────┐┌───────┐
└──┐ ││ ┌──────┐ │└──┐ │└──┐ ││ ││ ┌┐ ││ ││ ││ ┌┐ │└──┐ │└─────┐ │└─────┐ │
┌──┘ ││ └──┐┌──┘ │┌──┘ └──┐│ ││ └┘ ││ ││ ││ ││ ││ │┌──┘ └──┐┌──┘ │┌─────┘ │
│ ┌──┘│ ┌┐ ││ ┌──┘│ ┌───┐ ││ ││ ┌──┘│ ││ ││ ││ ││ ││ ┌─────┘│ ┌──┘│ ┌───┐ │
│ │┌──┘ ││ ││ └──┐│ └──┐│ ││ ││ └──┐│ └┘ ││ ││ ││ ││ └─────┐│ └───┘ │┌──┘ │
│ │└────┘│ │└──┐ │└──┐ │└─┘│ │└──┐ │└────┘│ ││ ││ │└─────┐ │└───────┘│ ┌──┘
│ └─────┐│ │┌─┐│ └───┘ │┌──┘ │┌──┘ └──┐┌──┘ ││ ││ └──┐┌──┘ │┌────┐┌─┐│ └──┐
└─────┐ ││ ││ ││ ┌─────┘│ ┌──┘└───────┘│ ┌──┘└─┘│ ┌──┘│ ┌┐ ││ ┌┐ ││ │└──┐ │
┌────┐│ └┘ ││ └┘ │┌─────┘ │┌──────────┐│ │┌─────┘ │┌──┘ ││ └┘ ││ └┘ └──┐│ │
│ ┌┐ │└────┘│ ┌──┘│ ┌─────┘│ ┌──────┐ ││ ││ ┌───┐ ││ ┌──┘│ ┌──┘└──┐ ┌──┘│ │
│ ││ │┌────┐│ └──┐│ └─────┐│ └─────┐│ ││ └┘ │┌──┘ ││ │┌──┘ │┌────┐│ │┌──┘ │
│ │└─┘│ ┌┐ │└──┐ │└─────┐ │└─────┐ ││ │└────┘│ ┌──┘│ │└────┘│ ┌┐ │└─┘│ ┌──┘
│ └───┘ ││ └───┘ └─────┐│ └──────┘ ││ └──────┘ └──┐│ └──────┘ ││ └───┘ └──┐
└───────┘└─────────────┘└──────────┘└─────────────┘└──────────┘└──────────┘