┌─┐┌───────────────────┐┌────┐┌───────┐┌──────────┐┌──────────────────────┐
│ │└──┐ ┌──────┐ ┌┐ ┌──┘│ ┌┐ ││ ┌┐ ┌──┘│ ┌───┐ ┌┐ ││ ┌──────┐ ┌─────────┐ │
│ └──┐│ │┌────┐│ ││ │┌──┘ ││ └┘ ││ └───┘ └──┐│ ││ ││ └─────┐│ │┌───────┐│ │
└──┐ ││ ││ ┌┐ ││ │└─┘│ ┌──┘└────┘└──────────┘│ ││ │└───────┘│ ││ ┌┐ ┌──┘│ │
┌─┐│ ││ ││ ││ ││ └──┐│ └──┐┌───────┐┌─┐┌─────┘ ││ │┌────────┘ ││ ││ │┌──┘ │
│ ││ │└─┘│ ││ ││ ┌┐ │└──┐ ││ ┌───┐ ││ ││ ┌─────┘│ ││ ┌────────┘└─┘│ ││ ┌──┘
│ ││ └──┐│ ││ ││ ││ └──┐│ └┘ │┌─┐│ ││ ││ │┌────┐│ ││ │┌──────────┐│ ││ │┌─┐
│ │└──┐ ││ ││ │└─┘│ ┌┐ │└────┘│ ││ ││ ││ ││ ┌──┘│ ││ ││ ┌──────┐ ││ ││ ││ │
│ └──┐│ ││ ││ └───┘ ││ │┌─────┘ └┘ ││ ││ ││ │┌──┘ ││ ││ └──┐┌──┘ └┘ ││ ││ │
│ ┌──┘│ ││ │└───────┘│ ││ ┌────────┘│ ││ ││ ││ ┌──┘│ │└──┐ │└───────┘│ ││ │
│ └──┐│ ││ └──┐┌─────┘ ││ └──┐┌─────┘ ││ ││ ││ │┌──┘ └──┐│ └─────┐┌──┘ ││ │
│ ┌┐ ││ ││ ┌┐ │└───────┘└──┐ ││ ┌───┐ ││ ││ ││ ││ ┌───┐ │└──┐ ┌┐ ││ ┌──┘│ │
│ ││ └┘ ││ ││ └──┐┌────────┘ └┘ │┌─┐│ ││ ││ └┘ ││ └──┐│ └──┐│ ││ └┘ │┌──┘ │
│ │└────┘└─┘│ ┌┐ ││ ┌───────────┘│ ││ ││ │└──┐ │└──┐ │└──┐ ││ │└────┘│ ┌┐ │
│ └────────┐│ ││ └┘ └──┐┌───────┐│ └┘ ││ └──┐│ └──┐│ └──┐│ ││ └──────┘ ││ │
└────────┐ │└─┘└───────┘│ ┌───┐ ││ ┌──┘└──┐ │└──┐ ││ ┌──┘│ │└──────────┘│ │
┌───────┐│ └──┐┌────────┘ │┌──┘ ││ └──┐┌──┘ │┌─┐│ ││ │┌──┘ │┌───────────┘ │
└─────┐ │└──┐ ││ ┌────────┘│ ┌──┘└──┐ ││ ┌──┘│ ││ ││ ││ ┌──┘└────────┐ ┌──┘
┌─────┘ └──┐│ └┘ │┌─┐┌─────┘ │┌────┐│ ││ └──┐│ ││ ││ ││ └───────────┐│ └──┐
│ ┌──────┐ │└────┘│ ││ ┌─────┘│ ┌┐ │└─┘└──┐ ││ ││ ││ │└───────────┐ │└──┐ │
│ │┌────┐│ │┌─────┘ ││ │┌─────┘ ││ └──────┘ ││ └┘ ││ └─────┐┌─┐┌──┘ │┌──┘ │
│ │└──┐ ││ ││ ┌─────┘│ ││ ┌───┐ │└──┐ ┌─────┘│ ┌──┘└─────┐ ││ ││ ┌──┘│ ┌──┘
│ └──┐│ ││ ││ │┌─────┘ ││ └──┐│ └──┐│ │┌────┐│ └────────┐│ └┘ ││ │┌──┘ │┌─┐
└──┐ ││ ││ ││ ││ ┌─────┘└──┐ │└──┐ │└─┘│ ┌┐ │└────────┐ │└────┘│ ││ ┌──┘│ │
┌──┘ ││ └┘ ││ ││ │┌───────┐│ └──┐│ │┌──┘ ││ │┌────┐┌──┘ │┌────┐│ ││ │┌──┘ │
│ ┌──┘│ ┌──┘│ ││ │└─────┐ │└──┐ ││ ││ ┌──┘│ ││ ┌──┘│ ┌──┘│ ┌┐ ││ ││ ││ ┌┐ │
│ └──┐│ └───┘ ││ └──┐┌──┘ └──┐│ ││ └┘ │┌─┐│ ││ └───┘ └───┘ ││ └┘ ││ ││ ││ │
│ ┌┐ │└───────┘└──┐ ││ ┌─────┘│ │└────┘│ ││ ││ ┌─────────┐ │└────┘│ │└─┘│ │
│ ││ └────────┐┌──┘ ││ └──────┘ │┌─────┘ ││ ││ │┌────┐┌─┐│ │┌────┐│ └───┘ │
└─┘└────────┐ ││ ┌──┘│ ┌────────┘└──┐ ┌┐ ││ ││ ││ ┌┐ ││ ││ ││ ┌┐ │└───────┘
┌────┐┌─────┘ ││ └──┐│ │┌───────────┘ ││ ││ ││ ││ ││ ││ └┘ ││ ││ └────────┐
│ ┌┐ ││ ┌───┐ │└──┐ ││ ││ ┌───┐ ┌─────┘│ ││ │└─┘│ ││ │└──┐ ││ │└────────┐ │
│ ││ ││ │┌──┘ │┌──┘ ││ ││ └──┐│ │┌────┐│ ││ └───┘ ││ └──┐│ ││ └────────┐│ │
│ ││ ││ │└────┘│ ┌──┘│ │└────┘│ ││ ┌┐ ││ │└───────┘└──┐ │└─┘└────────┐ ││ │
│ ││ └┘ │┌─────┘ │┌─┐│ └─────┐│ └┘ ││ ││ └──┐┌───────┐│ └─────┐┌─────┘ ││ │
│ ││ ┌──┘│ ┌─────┘│ │└─────┐ ││ ┌──┘│ ││ ┌──┘│ ┌───┐ ││ ┌───┐ ││ ┌─────┘│ │
│ ││ │┌──┘ │┌─────┘ └─────┐│ ││ │┌──┘ ││ │┌──┘ │┌──┘ ││ └──┐│ └┘ └─────┐│ │
│ │└─┘│ ┌──┘│ ┌─────────┐ ││ │└─┘│ ┌──┘│ ││ ┌──┘│ ┌──┘│ ┌──┘└──────────┘│ │
│ └───┘ │┌─┐│ └──┐┌─────┘ ││ │┌──┘ │┌─┐│ ││ │┌──┘ │┌──┘ │┌───────┐┌─────┘ │
│ ┌─────┘│ │└──┐ ││ ┌─────┘│ ││ ┌──┘│ ││ ││ ││ ┌──┘│ ┌──┘│ ┌───┐ ││ ┌───┐ │
│ │┌────┐│ └──┐│ ││ └─────┐│ └┘ │┌──┘ └┘ ││ ││ └──┐│ │┌──┘ │┌─┐│ ││ │┌─┐│ │
│ ││ ┌┐ │└──┐ ││ │└─────┐ │└──┐ │└───────┘│ │└──┐ ││ ││ ┌──┘│ ││ ││ ││ ││ │
│ └┘ ││ └──┐│ ││ └─────┐│ └───┘ │┌────────┘ │┌─┐│ ││ ││ └──┐│ ││ └┘ ││ ││ │
└────┘└──┐ ││ ││ ┌─────┘└───────┘│ ┌────────┘│ ││ │└─┘└──┐ ││ │└────┘│ ││ │
┌────┐┌──┘ ││ └┘ │┌───────┐┌─────┘ │┌───────┐│ ││ │┌────┐│ ││ └──┐┌──┘ └┘ │
│ ┌┐ ││ ┌──┘│ ┌──┘│ ┌───┐ ││ ┌─────┘│ ┌───┐ ││ ││ ││ ┌┐ ││ ││ ┌┐ ││ ┌─────┘
│ ││ ││ └──┐│ └──┐│ │┌─┐│ └┘ │┌─────┘ │┌──┘ └┘ ││ └┘ ││ └┘ ││ ││ └┘ │┌────┐
│ ││ │└──┐ │└────┘│ ││ │└────┘│ ┌─────┘└───────┘└────┘└────┘│ │└────┘└──┐ │
│ ││ └───┘ └──────┘ ││ └──────┘ └───────────────────────────┘ └─────────┘ │
└─┘└────────────────┘└────────────────────────────────────────────────────┘